111111111
1P00000C1
100C11101
1110010C1
1C0100001
110111101
1000000C1
1CC1C0E11
111111111