11111111111111111111111111111
1P00000C000000000000000000001
100C1110000000000000000000001
1110010C111111111110111111111
1C010000000000000000000000001
11011110000000000000000000001
100000000000000000000000000C1
1CC1C0E0000000000000000000011
100000000000000000000000000C1
111111110000001111110000111C1
100000000000000000000000000C1
100000000000000000000000000C1
100000000000000000000000000C1
111111111111111111111111100C1
11111111111111111111111111111