111111
1P0001
1000011111111
1C00000000001
100000C0000E1
1111111111111