111111111111
111111111111
111111111111
111111111E11
111111111C11
111111111P11
111111111111